###############
#S    #       #
# ### # ##### #
#   #   #   #T#
# # ####### # #
# #   #   #   #
# ##### # #####
#     # # #   #
# ##### # # # #
#T          #E#
###############
