###############
#S#   #     T #
# # # # # ### #
#   # # #   # #
### # ##### # #
#   #   #   # #
# ####### ### #
#T    #   #   #
# ### ##### # #
#   #       #E#
###############